wwwwwwwwwwwwwwwwwwwwwwwwww
w-------------A----------w
w------------------------w
w------------------------w
w------------------------w
w------------------------w
w------------------------w
w------------------------w
w-----c------------------w
w------------------------w
w------------------------w
w-------------------e----w
wwwwwwwwwwwwwwwwwwwwwwwwww
