wwwwwwwwwwwwwwwwwwwwwwwwww
w----x-----A-----w-------w
w------------wwwww--x----w
wx--wwwwwwwwww---w-------w
w---w--------w---w---x---w
w---w---x----w---w-------w
w------------w-----x---c-w
w---wwwwwwwwwwwwwwwwwwww-w
w-x----------w-------x---w
w----------x-w--x--------w
w---wwwwww---www----x----w
w----------e-------------w
wwwwwwwwwwwwwwwwwwwwwwwwww
