wwwwwwwwwwwwwwwwwwwwwwwwww
w----x-----A-------------w
w--------------------x---w
wx----wwwwwwww-----------w
w---------------x----x---w
w-------x----w-----------w
w------------w-----x-----w
w---wwwwwwwwwwwwwww------w
w-x----------w-------x---w
w----------x-w--x--------w
w------------w------x----w
w----------e-------------w
wwwwwwwwwwwwwwwwwwwwwwwwww
