wwwwwwwwwwwwwwwwwwwwwwwwww
w----x-w---A-----------x-w
w------w-------w----x----w
wx---wwwwwwwwwwwwwwww----w
w----w----w---x--w---x---w
w----w--x-w------w-------w
w----w----w--w---w-------w
w---wwwwwww------w-------w
w-x----w---------ww--x---w
w------w---x----x-w------w
w---x--w----------w------w
w----------e-------------w
wwwwwwwwwwwwwwwwwwwwwwwwww
