wwwwwwwwwwwwwwwwwwwwwwwwww
w--------w-A---------xx--w
w-------wxw--------w-----w
w--------w---------w-x---w
w------------------w-x---w
w---w--------------w-x---w
w--wxw-----x-------w-x---w
w---w--------------w---x-w
w------------------w---x-w
w------------------w----xw
w------------------------w
w----------e-------------w
wwwwwwwwwwwwwwwwwwwwwwwwww