wwwwwwwwwwwwwwwwwwwwwwwwww
w--------c-----------w---w
w--------------------w---w
w--------------------w---w
w------------------------w
w--------------------w---w
w------------------c-w---w
w-------------------Aw---w
w---------------wwwwww---w
w------------------------w
w------------------------w
w-------------------e----w
wwwwwwwwwwwwwwwwwwwwwwwwww
